1111111111111111111111111111111111111111111111111111
1001000000000000000000000000000000000000011111111111
1000P00000000011111111111110000000000000111111111111
1000000000000000000CC00CCC00000000000000111111111111
10000C0000000011111111111100000000000000111111111111
1000000000000011111111111100000000000000111111111111
1000000000000011111111111100000000000000111111111111
1000000000000011111111111100000000000000111111111111
1000000000000011111111111100000000000000111111111111
100000000E000011111111111100000000000000111111111111
1111111111111111111111011100000000000000111111111111
1000000000000011111111111100000CCCCCCCCC111111111111
1000000001000011111111111100000000000000111111111111
1000000000000011111111111100000000000000111111111111
1000000000000011111111111100000000000000111111111111
1000000000000011111101111100000000000000111111111111
10000000000000111111111111000000000C0000111111111111
1000000000000011111111111100000000000000111111111111
1111101111111111111111011100000000000000111111111111
1111101111111111111111011100000000000000111111111111
1111101111111111111111011100000000000000111111111111
1111101111111111111111011100000000000000111111111111
1111101111111110111111011100000000000000111111111111
1111101111111111111111011100000000000000111111111111
111110111111111111111101110000000C000000111111111111
1111111111111101111111011100000000000000111111111111
1111111111111111111111011100000000000000111111111111
1111111111111111111111011100000000000000000000000001
1111111111111111111111011100000000000000111111111111
1111111111111111111111111111111111111111111111111111
