111111111111111
1001000000P0001
100CCCCCCCCCCC1
100000000E00001
111111111111110
